#########
######T##
#TB/////#
#P////B/#
#///////#
#///////#
#//////##
#########