###########
#  b     t#
#     /  t#
#    #b#  #
#p        #
###########