##########
#tb  #####
# #////BT#
#  //#####
#  //#####
# p/######
##########