##########
# /p/ / /#
#/ / / / #
# / / / /#
#/ /b/ / #
# / / / /#
#/ / / / #
# / / / /#
#/ /t/ / #
##########