##########
##T#######
##//////T#
##/b  b/##
##/  p /##
##/b  b/##
#T//////##
#######T##
##########