########
#T/////#
##/ bb/#
##/   T#
##/ b /#
##/ p /#
##/////#
##T#####
########