#############
#p  #########
# b #########
#   #########
#///#########
#///#########
#///#########
#///#####T###
#///////////#
#////////BBT#
#T/////// //#
#############