########
#p   ###
##   ###
##   bt#
########