#####
## t#
# b #
#   #
##p##
#####