######
#t t##
##   #
##b  #
## b #
##   #
###p##
######