########
#     p#
#   bb #
#  #####
#     t#
#     t#
########