######
#    #
# pbt#
#    #
#    #
#    #
#    #
#   b#
# t  #
######