#########
####t####
#   c   #
#    b  #
#  p    #
#########