########
#####t##
#pb////#
#  ////#
#  ////#
#    c #
#      #
########