##########
#        #
# #T    t#
# #b  c B#
#  p     #
##########