############
#//////////#
#/       t/#
#/ ccccc  /#
#/ ccccc  /#
#/ ccpcC b/#
#/ ccccc  /#
#/ ccccc  /#
#/   b   t/#
#//////////#
############