
#################
##//////////////#
##/############/#
##/#     p    #/#
##/###        #/#
#///CcccccccccbT#
####/#        #/#
####B#        #/#
####T#//////////#
#################