#############
#  /  #  /  #
# c/p # c/b #
#///////////#
# c/  # c/  #
#  /  #  /  #
###/#####/###
#  /  #  /  #
#  /  #  /c #
#T/B////////#
#  /  #  /  #
#  /  #  / t#
#############