##############
#pc ////////##
#   #######T##
#   #######/##
#   #######/##
#   #######/##
#   #######/##
#   ######/C/#
#   #######B##
#  c/////// /#
#  c/////// /#
##############
